1111111111111111111111111111
1000000000000000000000000001
1000000000000000000010000001
10000000000C00000001E1000001
1000000000000000000000000001
100000000000000C000000000001
1000000000000000000000000001
10000001C1000000000000000001
1000000010000000000000000001
1000000000000000000000000001
1000000000000000000000000001
10000000C0000000000010000001
10000000000000100101C1000001
10000000P0000010000000000001
1111111111111111111111111111