1111111111
1CCCCP1CC1
1C11C111C1
1CE1CCPCC1
1111111111